1 13 31
###############################
#      ** *  1 * 2 *  * * *   #
# # # #*# # #*#*# # # #*#*#*# #
#  x*     ***  *  1   * 2 * * #
# #     # #*# # #*#*# # # # #*#
#s   s  p  x **  *  *   1     #
# #   # # # # # # #*# #*# # # #
#*  *      *  *      *        #
# #   # #*# # # #*#*# # # # # #
#*    **  *       *           #
# #*# # # # # # #*# # # # # # #
#           *   *  *          #
###############################