2 13 31
###############################
#p  * *        *  ** * *     *#
#s      #*# # #*# # # # # #*# #
#    x * *** **      *   **   #
# #*# # # # # # #b##  # # # #*#
#          *x     **      * **#
#*# #*# ## # # #*#*#*#*# #  # #
#    *f        *s   * *x* *   #
# #     #*# # # # # # #*# #*# #
#   ****1        *            #
# # # # # # # # # #*# # # # #*#
#  ** *   *                   #
###############################