4 13 31
###############################
#p   ** **    *   2           #
# # # #*# # # # # # # # # # # #
#*     ** * *  *   * ** 3 *   #
# # # # # #*# # # # # # #*# # #
#*   *s*5    *** * x **       #
# # # # # # # # # # # # # #*# #
#    *     *        *    **   #
# #*# # #*#*#*#*# # #1# # #*# #
# 4       *   *2*    *   *    #
#*# # # # # # # # # # #*# # #*#
# *    * **    ** ***     1   #
###############################