1 13 31
###############################
#       ** *   *  *  * * *    #
# # # #*# # #*#*# # # #*#*#*# #
#     *      ***  *    *  * * #
# s     # #*# # #*#*# # # # #*#
#2       p  x **  *  *        #
# #   # # # # # # #*# #*# # # #
#*  *      *  *      *s     s #
# #   # #*# # # #*#*# # # # # #
#* 1    **  *       *         #
# #*# # # # # # #*# # # # # # #
#           *   *  *          #
###############################