2 13 31
###############################
#p * *        *  ** * *      *#
#       #*# # #*# # # # # #*# #
#1    x * *** **     *    **  #
# #*# # # # # # #b##  # # # #*#
#          *     **      *  **#
# # #*# # # # # #*#*#*#*# # # #
#   *        *   * *x* *      #
# #     #*# # # # # # #*# #*# #
#   ****         *            #
# # # # # # # # # #*# # # # #*#
#  ** *   *                   #
###############################