5 13 31
###############################
#p * *3       x*  ** * *     *#
# # # # #*# # #*# # # # # #*# #
#s    *f* *** **  3   *    ** #
# #*# # # # #4# #b#1# # # # #*#
#          f*     **      * **#
# # #*# # # # # #*#*#*#*# # # #
#   *5       *   * * * *   4  #
# # # # #*# # # # # # #*# #*# #
#   ****         *2           #
# # # # # # # # # #*# # # # #*#
#  ** *5  *    2              #
###############################