2 13 31
###############################
#p * *        *  ** * *      *#
#s      #*# # #*# # # # # #*# #
#1    x * *** **     * 2  **  #
# #*# # # # # # #b##  # # # #*#
#          *     **      *  **#
# # #*# # # # # #*#*#*#*# # # #
#   *        *   * *x* *      #
# #     #*# # # # # # #*# #*# #
#   ****1        *            #
# # # # # # # # # #*# # # # #*#
#  ** *   *                   #
###############################