5 13 31
###############################
#p           xf  ** * *1     *#
# s * # #*# # #*b # # # # #*# #
#s    *f* *** **  3   *    ** #
# #*# #s# # # # #b#1# # # # #*#
#          f*     **      * **#
# x #*# # # # # #*#*#*#*# # # #
#   *5       s  * * * *   4   #
# b # # #*# # # # # # #*# #*# #
#   ****         *2           #
# # # # # * # # # #*# # # # #*#
#  ** *   *                   #
###############################