4 13 31
###############################
#p   s* **    *   2           #
# # # #*# # # # x # # # # # # #
#*     ** * *  *   * ** 3 *   #
# # # # # #*# # # # # # #*# # #
#*   *s*5    ** * x **        #
# # # # # # # # # # # # # #*# #
#    *     *        *    **   #
# #*# # #*#*#*#*# # # # # #*# #
# 4       *   *2*    *   *    #
#*# # # # # # # # # # #*# # #*#
# *    * **    ** ***     1   #
###############################