2 13 31
###############################
#p          *f *  ** * *     *#
#s      #*# # #*# # # # # #*# #
#    x * *** **1     *   **   #
# #*# # # # # # #b##  # # # #*#
#          *b     **      * **#
#*# #*# ## # # #*#*#*#*# #  # #
#2   *f        *s   * *x* *   #
# #     #*# # # # # # #*# #*# #
#   ****1        *            #
# # # # # # # # # #*# # # # #*#
#  ** *   *                   #
###############################