1 13 31
###############################
#       ** *   *  *  * * *    #
# # # #*# # #*#*# # # #*#*#*# #
#    * 4     ***  *    *  * * #
# s     # #*# # #*#*# # # # #*#
#    f  p  x **  *  *         #
# #   # # # # # # #*# #*# # # #
#*  *      *  *      *s     s #
# #   # #*# # # #*#*# # # # # #
#*2    **  *       *          #
# #*# # # # # # #*# # # # # # #
#3          *   *  * 1        #
###############################