5 13 31
###############################
#p           x*  ** * *      *#
#   # # #*# # #*b # # # # #*# #
#s    *f* *** **  3   *    ** #
# #*# #s# # # # #b#1# # # # #*#
#          f*     **      * **#
# x #*# # # # # #*#*#*#*# # # #
#   *5       *   * * * *   4  #
# b # # #*# # # # # # #*# #*# #
#   ****         *2           #
# # # # # * # # # #*# # # # #*#
#  ** *   *                   #
###############################