3 13 31
###############################
#p   ** **    *   2           #
# # # #*# # # # # # # # # # # #
#*     ** * *  *   * **   *   #
# # # # # #*# # # # # # #*# # #
#*   *s*    *** * x **        #
# # # # # # # # # # # # # #*# #
#    *     *        *    **  4#
# #*# # #*#*#*#*# # #1# # #*# #
#        *   *1     *   *     #
#*# # # # # # # # # # #*# # #*#
# *    * **    ** ***     1   #
###############################