1 13 31
###############################
#       ** *   *  *  * * *    #
# # # #*# # #*#*# # # #*#*#*# #
#2    *      ***  *    *  * * #
# s     # #*# # #*#*# # # # #*#
#     f  p  x **  *  *        #
# #   # # # # # # #*# #*# # # #
#*  *       *  *      *s    s #
# #   # #*# # # #*#*# # # # # #
#* 1    **  *       *         #
# #*# # # # # # #*# # # # # # #
#           *   *  *          #
###############################