1 13 31
###############################
#      ** *  1 * 2 *  * * *   #
# # # #*# # #*#*# # # #*#*#*# #
#  x*     ***  *  1   * 2 * * #
# f     # #*# # #*#*# # # # #*#
#f   f  p  x **  *  *   1     #
# #   # # # # # # #*# #*# # # #
#*  *      *  *      *        #
# #   # #*# # # #*#*# # # # # #
#*    **  *       *           #
# #*# # # # # # #*# # # # # # #
#           *   *  *          #
###############################