3 13 31
###############################
#p    * f**    *   2          #
# s # #*# # # # # # # # # # # #
#*     ** * *  *   * **   *   #
# # # # # #*# # # # # # #*# # #
#*   *s*    *** * x **        #
# # # # # # # # # # # # # #*# #
#    *     *        *    **  4#
# #*# # #*#*#*#*# # #1# # #*# #
#        *   *1     *   *     #
#*# # # # # # # # # # #*# # #*#
# *    * **    ** ***      1  #
###############################