1 13 31
###############################
#      ** *   *  *  * * * 1   #
# # # #*# # #*#*# # # #*#*#*# #
#  x* 1     ***  *     *  * * #
# f     # #*# # #*#*# # # # #*#
#s   f  p  x **  *  *   4     #
# #   # # # # # # #*# #*# # # #
#*  *      *  *      *        #
# # 2 # #*# # # #*#*# # # # # #
#*    **  *       *           #
# #*# # # # # # #*# # # # # # #
#           *   *  *       3  #
###############################