1 13 31
###############################
#      ** *   *  *  * * *     #
# # # #*# # #*#*# # # #*#*#*# #
#  x* 1     ***  *     *  * * #
# f     # #*# # #*#*# # # # #*#
#f   f  p  x **  *  *         #
# #   # # # # # # #*# #*# # # #
#*  *      *  *      *        #
# #   # #*# # # #*#*# # # # # #
#*    **  *       *           #
# #*# # # # # # #*# # # # # # #
#           *   *  *          #
###############################