1 13 31
###############################
#       ** *   *  *  * * *    #
# # # #*# # #*#*# # # #*#*#*# #
#    * 4     ***  *    *  * * #
# s     # #*# # #*#*# # # # #*#
#x   f  p  x **  *  *         #
# #   # # # # # # #*# #*# # # #
#*  *      *  *      *s     s #
# #   # #*# # # #*#*# # # # # #
#*    **  *       *           #
# #*# # # # # # #*# # # # # # #
#           *   *  * 1        #
###############################